01001110 'n'
01101001 'i'
01100011 'c'
01100101 'e:'
00100000 ' '
01101010 'j'
01101111 'o'
01100010 'b'
00101110
00100000
01001110
01101111
01110111
00100000
01110100
01111001
01110000
01100101
00100000
00100111
00101111
01101101
01110011
01100111
00100000
01010100
01010010
01011001
00110010
01001000
01000001
01000011
01001011
00100000
01110011
01101000
01101111
01110111
01100010
01110101
01100111
00100111
00100000
01110100
01101111
00100000
01110011
01100101
01100101
00100000
01110100
01101000
01100101
00100000
01100010
011101
